                        





NO	../assets/BrickMoss.png

SO	 ../assets/Tile.png

WE	  ../assets/Copper.png

EA	 ../assets/WoodDark.png

F 255,100,0

C 225,30,0


11111111111011111111
100000000000000000E1
100000000000000000011111
100000000000000000000001
100000000000000000011111
10000000000000000001
11111111111111111111

			