                        





NO	./assets/BrickMoss.png



SO	 ./assets/Tile.png



WE	  ./assets/Copper.png



EA	 ./assets/WoodDark.png



F 255,100,0



C 225,30,0

000
11111111111111111111
11111111111111111111
100000000000000000E11111111111111111111
100000000000000000011111111111111111111
100000000000000000011111111111111111111
1000000000000000000111111111111111111110
10000000000000000001
11111111111111111111
11111111111111111111
0


			