NO	assets/BrickMoss.xpm

SO	assets/BrickMoss.xpm
WE	assets/BrickMoss.xpm

EA	assets/BrickMoss.xpm

F 255,100,0

C 225,30,0

11111111111111111111
00000000000000000N1
10000000000000000001
10000000000000000001
10000000000000000001
10000000000000000001
11111111111111111111