NO	assets/BrickMoss.xpm

SO	assets/Caillou.xpm

WE	 assets/Copper.xpm

EA	 assets/WoodDark.xpm

F 255,100,0

C 225,30,0


111111111111111111111111
100000000000001000010001
100100011000001000000101
100000011000001000010001
100100011000001001110101
100000000000001000010101
100000000000001111010101
101111111111101000010001
100000000000001011111101
101010101010101000010001
100000000000001111W10111
100111100000000000010111
100000100000000000010111
100100100000000000010011
100100100000000000011011
100100100000000000000011
100000100000000000011111
111111111111111111111111
			